Here follow certaine wordes of the language of Trinidad which I observed at my being there.



Guttemock.	A man.



Tabairo, Dabarah,] t,,	, c	.



tÂ» u r The heare or ones head. Or Dabarra.J



Dessie	The forehead.



Dasereth, or	Dacosi	An eye.



Dalacoack	The mouth.



Archeh	The teeth.



Daria	The gummes.



Desire	The lips.



Dill	The tongue.



Dudica	The eares.



Dacan	A hand.



Dacabbo	The palme of the hand.



Diidena	The wrist.



Dacurle	A knee.



Daddano	The calfe of the legge.



Dabodda	The toes.



Dacutti	The feete.



Cattie	The moone.



Tauraroth	A rope.



Arkeano	A paire of cizers.



Weevah	The heaven.



Harowa	A stone good for the head ache.



211



* It is before in this voyage called Calvorie.



[HI. 578-]



* The name of the river Orenoque may seeme to be derivedfrom this word.



Mointiman	Yron or steele.



Howa	Munkeis in general.



Carotta	A thing like pappe.



Sakel	It	is well, or I am well.



Techir	A bracelet.



Bodad	A boxe or chest.



Mentinie	A tree.



Addehegaeno	A glasse.



*Calcouri	Gold.



Perota	Silver.



Tacorao a green stone.	}	{ Arrara copper.



Caulpiri	A white stone.



Casparo A sword. }	{ Tibetebe cockles.



Marrahabo a bow. }	{ Semaro an arrow.



Huculle	A bow-string.



Halete	A Potato roote.



Caerwoda	A sweete root.



Maurisse Wheat. }	{ Queca A basket.



Yeddola A knife. }	{ Sambolers A hat.



Beyou A pipe. }	{ Callit	Bread.



*Oronuie	Water.



Arguecona	A paire of cizzers.



Heldaro	A spoone.



Hemachugh	A	bread which they eate.



Hicket Fire. }	{ Walrowa A parrot.



Ureit Tabacco. }	{ Barudda A combe.



Addoth	A sticke.



Barrennaire	A button, or beads.



Curaballa & Sibath, for	2 sundry stones : but



Sibath in general signifieth a stone.	



Tolletillero bels. }	{ Ullasso a Tuny-fish.



Bohery A flying fish. }	{ Bara Water.



Haddalle	The Sunne.



Babage-Canoaseen	The manner of the



Indians hailing of a	ship, calling it after



the name of their Canoas.	



Non quo, Or	1 I know not, Or



Non quapa 21	J I cannot tell. 2
